%##########%
.@@..@@..@@.
#..%%..%%..#
#@@@@@@@@@@#
############
............
%##########%
#@@..@@..@@#
#..%%..%%..#
#@@@@##@@@@#
############
............
............